000000000000000000000000000000000000000000000000000000000000000000000000000000000000000000
000000000000000000000000000000000000000000000000000000000000000000000000000000000000000000
000000000000000000000000000000000000000000000000000000000000000000000000000000000000000000
000000000000000000000000000000000000000000000000000000000000000000000000000000000000000000
000000000000000000000000000000000000000000000000000000000000000000000000000000000000000000
0000000000000000000000000000000000000000000000000000000000000000000000000000000000000000000
000000000000000000000000000002222200000000000000000000000000000000000000000000000000000000
000000022222000000000000000000000000000000000000000000000000000000000000000000000000000000
00002222200000000000000000000000000000000000000000000000000000000000000000000000000000000
0000022222000000000000000000000000000000000000000000000000000000000000000000000000000000000
11222222222222222111122222222222222211112222222222222221111222222222222222111122222222222222211
111111111111111111100001111100111111111111111111100001111100111111111111111111100001111100
111111111111111111100000110000111111111111111111100001111100111111111111111111100001111100
111111111111111111100000100000111111111111111111100001111100111111111111111111100001111100
111111111111111111100000100000111111111111111111100001111100111111111111111111100001111100
111111111111111111100000000000111111111111111111100001111100111111111111111111100001111100